00000000000000000000000000000000
00000000000000000000000000000000
00000000000000011111111111110000
00000000000000001000000000011000
00000000000000001000011110001000
00000000000000001000010010001000
00000000000000001000010010001000
00000000000000001000010010001110
00000000000000001000010010000010
00000000000000001000010010000010
00000000000000001000010010000010
00000000000000001000010010000110
00000000000000001110010010000100
00000000000000000010010011111100
00000000000000011110010000000000
00000000000000000000011111111112