00000000000000000000000000000000
00000000000000010000000000000000
03111111000000011111111111110000
00000001000000001000000000011000
00000001111110001000011110001000
00000000010000001000010010001000
00000000010000001000010010001000
00000000010000001000010010001110
00000000011111111000010010000010
00000000000000001000010010000010
00000000000000001000010010000010
00000000000000001000010010000110
00000000000000001110010011111100
00000000000000000010010000000000
00000000000000011110011111111112
00000000000000000000000000000000